14
12
WWWWWWWWWWWWWW
WX           W
WXb b b b b  W
WXWWWWWWWWW  W
WXWXB b XXbBWW
WXW b b BXbmW
WXWX  b XXbbW
WXWWWWWWWWWXW
WX          W
WXWbWbWbWbWbW
WX          W
WWWWWWWWWWWWW
