10
6
WWWWWWWWWW
WW       W
W   WbWb W
W bb  XbXW
W mWWWXXXW
WWWWWWWWWW
