12
5
WWWWWWWWWWWW
W    XXX b W
W bbbBBB bmW
W    XXX b W
WWWWWWWWWWWW
