8 
7
  WWWWWW
  W    W
WWWbbb W
Wm bXX W
W bXXXWW
WWWW  W
   WWWW