9
8
WWWWWWWWW
WX XW mXW
W   W   W
W WbWWW W
Wb b    W
W    W  W
W    WWWW
WWWWWW   
