12
7
WWWWWWWWWWWW
WWW   X    W
W   WWbWW  W
W mbX X XbWW
WW bWWbWW WW
WW    X   WW
WWWWWWWWWWWW
