9
7
WWWWWWWW 
WXXXXXXW 
W  b W WW
W b W b W
WWb b b W
WW  m   W
WWWWWWWWW
