9
9
WWWWWWWWW
W   B   W
W   Xb  W
W b B   W
WBXBBBXBW
W   B b W
W  bX m W
W   B   W
WWWWWWWWW
